NO ./path_to_the_north_texture
SO ./path_to_the_south_texture
SO ./path_to_the_south_texture
WE ./path_to_the_west_texture
EA ./path_to_the_east_texture
EA ./path_to_the_east_texture
EA ./path_to_the_east_texture
EA ./path_to_the_east_texture 
EA ./path_to_the_east_texture
F 220,100,110
C 225,30,0
C 225,30,01
    1111111111111 111111111111
    1000000000111  100000000111
    10110000011101 11000000111
111100000000000001 10000001
111111111011000001 1100001111111
100000000011000001 110111111001111
1111011111111101111100000010011
11110111111111000000010010011
11000000000101011111000010001
100000000000000011 1000010001
10000N000000000011 1010010001
110000000001010111 101101001111111111
1111111111111111  1101101111 1111111111
11111111 11111 1 1111111111111111111111




         


