NO ./path_to_the_north_texture
SO ./path_to_the_south_texture
SO ./path_to_the_south_texture
WE ./path_to_the_west_texture
EA ./path_to_the_east_texture
EA ./path_to_the_east_texture
EA ./path_to_the_east_texture
EA ./path_to_the_east_texture 
EA ./path_to_the_east_texture
F 220,100,110
C 225,30,01
C 225,30,0
    1111111111111 111111111111
    1000000000111  100000000111
    10110000011101 11000000111
111100000000000001 10000001
111111111011000001 1100001111111
100000000011000001 110111111001111
111101111111110111 100000010011
111101111111110111 1010010001
1100W0001101010111 1100010001
100000000000000011 1000010001
100000000000000011 1010010001
110000011101010111 101111001111111111
11111111 1111111  1101111111 1111111111
11111111 1111111 1111111111111111111111




         


