NO ./textures/tatame_north_texture.xpm
SO ./textures/tatame_south_texture.xpm
WE ./textures/tatame_west_texture.xpm
EA ./textures/tatame_east_texture.xpm

C 179,182,183
F 33,47,61


    1111111111111 111111111111
    1000000000111  100000000111
    10110000011101 11000000111
111100000000000001110000001
11111111101100000000000001111111
1000000000110000011110111111001111
11110111111111011111000000100111
11110111111111000000010010011
11000000000101011111000010001
1S00000000000000011 1000010001
100000000000000011 1010010001
110000000001010111 101101001111111111
1111111111111111  1101101111 111111111
11111 11 11111 1 1111 111111111111111







