NO ./path_to_the_north_texture
SO ./path_to_the_south_texture
SO ./path_to_the_south_texture
WE ./path_to_the_west_texture
EA ./path_to_the_east_texture
EA ./path_to_the_east_texture
EA ./path_to_the_east_texture
EA ./path_to_the_east_texture 
EA ./path_to_the_east_texture
F 220,100,110
C 225,30,01
C 225,30,0
1111111111111 111111111111
1000000000111  100000000011
1011000001110110000000001
1001000000000000000000001
1111111110110000011100001111111
100000000011000001110111111001111
11110111111111011100000010001
11110111111111011101010010001
1100W000110101011100100010001
10000000000000001100000010001
10000000000000001101010010001
1100000111010101111101111001111111111
11111111 1111111 111101111111 1111111111
11111111 1111111 1111111111111111111111




         


